20
30
111111111111111111111111111111
100000010000000000000000000001
100000010000000000000000000001
100000010000000000000000000001
100000010000000000000000000001
100000010000000000000000000001
100000020000000000000000000001
100000020000000000000000000001
100000020000000000000000000001
100000010000000000000000000001
100000010000000000000000000001
100000010000000000000000000001
100000010000000000000000000001
100000010000000000000000000001
112211111111111111111112211111
100000000000000000000000000001
100000000000000000000000000001
100000000000000000000000000001
100000000000000000000000000001
111111111111111111111111111111